XXXXXXXXXXXXXX
X            X
X            X
X       m    X
X            X
